################################################################################
#X#   #     #   #   #   #   #   #                                              #
# # # # ### # # # ### # # #   #   # ##### #                                    #
#   # # # #   # #     #   ######### #     #                                    #
##### # # # ###   # ### # #   #     # #####                                    #
#         # #   # #     #   # # ##### #                                        #
# ##### ### # ### ##### # #####       ###                                      #
#   # # #     #         #       ### #                                          #
### #   # ##### ## # ## #### ####   ######                                     #
#   ##### #   # #  #  #    #      #      #                                     #
# ###   #   #   # ### ## # ############# ######                                #
#     # # ### ###     #  #   #   #   # #  #                                    #
## #### # #       # # ###### # # # # # ## #                                    #
#     #   ### # ### #  #   # # # # # #    #                                    #
# ### #####   # #   #    # #   #   #   # ##                                    #
# # #       # ### # ###### # ### ####### #                                     #
# # ####### #     #     #  # #         # # #                                   #
# #   #   # ########### # ## # ### ### #   #                                   #
# # #   # #       #     #    # #   #   ## ###                                  #
#   # ### ##### # # # ### #### # ### #  # #                                    #
# # #     #   # #   #   #      #     #    #                                    #
# ####### # # # # ### # # #### # #  ##### ##########                           #
#           #   #     #   #      #                  Y                          #
################################################################################